T------------------7
|     k      k     |
|  T---   --   --  |
|  |         k     |
|  | kT---      k  |
|  L--J  k         |
| k        ------  |
|  ---           k 
|        k    k      
|   k      ------  |
|   k         k    |
L------------------J
